0110000001
0000000110
1001010000
0000000000
0111000010
0121001000
0111000100
1000010000
0000000100
0010010010